11111111111111111111111111111111111111
13221222112222112222221122221122212231
12221212222112222111122221122221212221
12222212112222112222221122221121222221
11112222222112221211212221122222221111
00222111121111121211212111112111122200
11212222122222122222222122222122221211
12212112121112201011010221112121121221
12122222222222100000000122222222222121
12121212111212101199110121211121212121
12122212222222101000010122222221222121
12111212112112101567810121121121211121
12122212222112101111110121122221222121
12221212122222000000000022222121212221
11211222111121101111110112111122211211
00211212222222222211222222222221211200
11222211112111211242211211121111222211
12211212222222211211211222222221211221
13221222111111222211222211111122212231
11111111111111111111111111111111111111