11111111111111111111111111111111111111
13221222222122212222221222122222212231
12221211212221222111122212221211212221
12222212212111111111111111121221222221
11111212112222222222222222221121211111
12221212112111211111111211121121212221
12122222222222222222222222222222222121
12121121112112101011010121121112112121
12222222222222000000000022222222222221
11121121121112101199110121112112112111
00222221222222101000010122222212222200
11111222211121101567810112111222211111
12221211211122101111110122111211212221
12122211211112000000000021111211222121
12112112222222101111110122222221121121
12212112111112221111112221111121121221
11222212222222122242222122222221222211
12211211111211111211211111211111211221
13221222222222222211222222222222212231
11111111111111111111111111111111111111