11111111111111111111111111111111111111
13221222122211122222222111222122212231
12221212221222221111112222212221212221
12222211111111121111112111111111222221
11111222222222222222222222222222211111
12221211111111121111112111111111212221
12122221222112221222212221122212222121
12112122212222101211210122221222121121
12222221111212100000000121211112222221
11121122222212001199110021222222112111
00221111211112101000010121111211112200
11122222211222101567810122211222222111
12221121112212101111110121221112112221
12122221222112000000000021122212222121
12112121212222111111111122221212121121
12212121211212122211222121211212121221
11222222222222221242212222222222222211
12211211111212111211211121211111211221
13221222222212222211222221222222212231
11111111111111111111111111111111111111