11111111111111111111111111111111111111
13221222222222222211222222222222212231
12221212111112121222212121111121212221
12222212222222122211222122222221222221
11112111111111121111112111111111121111
11222221122222222222222222222112222211
01212122221212111111111121212222121210
01212121122212000000000021222112121210
01222222221112100000000121112222222210
11112121122222101199110122222112121111
00222221121111101000010111112112222200
11112121122222101567810122222112121111
01222222221112001111110021112222222210
01212121122212100000000121222112121210
01212122221212111011011121212222121210
01212112111222222211222222211121121210
11222222221211121242212111212222222211
12211211122211121211212111222111211221
13221222221222222211222222212222212231
11111111111111111111111111111111111111